1111111111111111111
100000000C000000C01
1000101000111100001
1C00101000000100001
1000111000111100001
100C001000100000001
100C001000111100001
1E000000000000X0001
1P0000X000C00000X01
1111111111111111111
