1111111111111111111
10X0X0X0X0X0X0X0XX1
1X010100011110000X1
1C00101000000100XX1
10001110001111000X1
100C001000100000XX1
100C0010001111000X1
1EC0CCC0000000X01X1
1P0XXXXXXXXXXXXXX01
1111111111111111111
