1111111111111111111
1000000000000000001
1X001010001111000C1
1C00101000000100XC1
10001110001111000C1
100C0010001000000C1
100C001000111100001
1EC0CCC0000000X00X1
1P00000000000000001
1111111111111111111
