111111
10X001
10X001
1PEC01
111111
