11111111111111
1E0C0100000001
1010C00101X001
1C1000101000C1
10CC0010X00001
10100C100X0001
1C100010C00P01
11111111111111
