1111111111
10000P00E1
1111111111
