1111111111
10P0C1E001
1111111111
